Stage 1
#####
#OoP#
#####
=====
Stage 2
  #######  
###  O  ###
#    o    #
# Oo P oO #
###  o  ###
 #   O  #  
 ########  
=====
Stage 3
 ###### 
#O    ##
# oPo  #
#     O#
 #    ##
  ####  
=====
Stage 4
 ### ### 
#   # O #
#   o   #
#  P o # 
#     #  
 #  O#   
  ###    
=====
Stage 5
  ####  
  #OO#  
 ## O## 
 #  oO# 
## o  ##
#  #oo #
# P    #
########